195
########################################
#************ @    *   *    **   *     #
#     *             C        *   #* * *#
########## H  #######    ##    *##  #* #
#      ***   *   * >  *   *    *##* ## #
# ######       * * #    *# #* #  * +   #
#       *   B    * #* ## # * ##    *##*#
# ######* ######  ##*##  #   #*    I## #
#V ******   #@ * *   *  * P       *  **#
########################################
