230
##########################################
#**         #**#**#*#   *    **   *      #
#C*    *     **#**#*#         *    * * * #
#**         #**#**#*#           *   ##*  #
#**     ***   *   *    *   *    *  * ##  #
#**# # ##  *x   * * #>   *   * #  *      #
#**# # ##*##  B   * #* ## # * ##    *##* #
#**# # ##  ##  ## ###*##  #   #* ## I##  #
#***   *        * *   *  * P       *  ** #
##########################################
