100
########################
#     #          >* &# #
#     #   #        *#P##
#                    # #
########################
