420
#########################
#  *  #*      **  * *  H#
#  *  #***#@         #* #
#  *  #***#      #*  #  #
#     #***#        ###  #
#     #***#       #     #
#     #####    C * # *I #
# ###    *    ###  #  * #
#P###+     ##  # * # #  #
# ### *     >     B *##*#
#*###   #  # ###   #  # #
# ###  V#  # ###  x#*   #
#********************* *#
#********************  @#
#########################
